NO ./path_to_the_north_texture
SO ./path_to_the_south_texture
WE ./path_to_the_west_texture
EA ./path_to_the_east_texture

F 220,100,0
C 225,30,0

111111111111111111111111111111111
100000000011000000000000100000001
100000000011000000000000100000001
110000000000000000000000100000001
111111111110000000000000111100001
110000000000000000000000000000001
100000000000000000000000000000001
100000001100000000000000000000001
100000001100000000000000000000001
100000000000000011000NS0100000001
100000000000000011010100100000001
110000011111111111111111100000001
11110111 1110001 1011110100000011
10000001 1000011 1100000000000001
111111111111111111111111111111111