111111111111111111111111111111111
100000000011000000000000101111111
101100000111000000000000101111111
111111111111111111111111101111111
111111111011000000000000000111111
000000000001000011101111101111111
111111111111111111000000001111111
111101111111110111010100100011111
110000001101010111000000100011111
100000000000000011000000100011111
100000000000000011010100100011111
11000001110101011111011110N011111
11110111 1110101 1011110100000000
11111111 1111111 1111111111111111
111111111111111111111111111111111